cellName	cluster
AAACGAACATTGAAGA	 keratocytes I
AAAGTCCAGAAAGTCT	 keratocytes I
AAAGTCCCAATAACCC	 keratocytes II
AAAGTGAAGCGCACAA	 keratocytes I
AAAGTGACAGTTGCGC	neural crest
AACAAGAAGCGAATGC	neural crest
AACCAACGTATGTCTG	 keratocytes I
AACCTTTCATTAGGAA	neural crest
AACGAAATCAGGAGAC	proliferating progenitors
AACGGGACATATCTGG	neural crest
AACTTCTAGAGTCGAC	mesoderm
AAGAACAAGCCACCGT	 keratocytes I
AAGACTCAGCGCCCAT	 keratocytes I
AAGCGAGAGTTGCCTA	 keratocytes I
AAGCGTTAGTGAACAT	proliferating progenitors
AAGGAATCACTGAATC	neural crest
AAGGAATTCGGCAGTC	 keratocytes I
AATCGTGTCCCAAGTA	neural crest
AATGAAGTCATTACTC	neural crest
AATGACCCAGGACTTT	neural crest
AATGACCGTCCTCAGG	neural crest
AATGCCACAGATTTCG	 keratocytes II
AATGGAACAGAGGTTG	proliferating progenitors
AATGGAACAGGATGAC	neural crest
AATTTCCCACGATAGG	neural crest
ACAACCATCACATTGG	neural crest
ACAGCCGGTTAGTCGT	 keratocytes I
ACATCGATCCTACAAG	 keratocytes I
ACCAAACTCCATCAGA	proliferating progenitors
ACCCAAAGTCACCGAC	mesoderm
ACCTACCGTAGATCCT	neural crest
ACCTGAAGTCGAGCAA	neural crest
ACCTGAATCCCAAGCG	 keratocytes II
ACGATGTGTACCTATG	proliferating progenitors
ACGGGTCCATCGTCCT	 keratocytes I
ACGTTCCGTCAAGTTC	 keratocytes I
ACTACGAGTGAATGAT	neural crest
ACTATTCCACTCGATA	proliferating progenitors
ACTGATGAGCAGGTCA	 keratocytes I
ACTGCAAAGAGTTGTA	proliferating progenitors
ACTGTCCAGGGATCTG	 keratocytes I
ACTGTCCAGTCACGAG	 keratocytes I
ACTGTCCTCATTACGG	neural crest
ACTGTCCTCGCTAAAC	neural crest
ACTGTCCTCTATGCCC	 keratocytes I
ACTGTGACAGCAGACA	neural crest
ACTTAGGTCCTTCTGG	 keratocytes I
ACTTAGGTCTCCTGTG	 keratocytes I
ACTTTCAAGGGCCAAT	 keratocytes I
ACTTTGTAGCAATAAC	mesoderm
AGACAGGGTGTGACCC	mesoderm
AGACCATGTACAAGTA	neural crest
AGACTCACACTTGACA	 keratocytes I
AGACTCATCGTTCCTG	 keratocytes I
AGAGAGCCAAGATGTA	 keratocytes I
AGAGAGCGTGCATGAG	proliferating progenitors
AGAGCCCTCTGCGGGT	 keratocytes I
AGATCCACACTGAGGA	neural crest
AGATCCAGTTGCCGAC	mesoderm
AGATGCTGTTCGTAAC	neural crest
AGCATCATCATTTCCA	 keratocytes I
AGCGATTTCGAGAACG	 keratocytes I
AGCGCCAGTAGGACTG	neural crest
AGCGCCAGTTGAGTCT	 keratocytes I
AGCTACAAGGGCAACT	neural crest
AGGAAATTCCTCACTG	neural crest
AGGACTTAGTATTCCG	mesoderm
AGGACTTCAAAGGCGT	neural crest
AGGATCTGTGTATACC	 keratocytes I
AGGCATTTCATTGAGC	neural crest
AGGGAGTAGATCACCT	neural crest
AGGGCCTGTGGAAGTC	 keratocytes I
AGGGTTTCAGTTGTCA	proliferating progenitors
AGGTGTTCAGTCCCGA	 keratocytes I
AGGTTGTTCTTACCAT	proliferating progenitors
AGTAGCTCATGGGTCC	 keratocytes I
AGTAGCTGTTGACTAC	proliferating progenitors
AGTAGTCGTAGGCTCC	neural crest
AGTCAACAGAAGGCTC	 keratocytes I
AGTCACATCGAGATAA	proliferating progenitors
AGTGACTTCGGAAGGT	neural crest
AGTGTTGAGCCTCCAG	mesoderm
AGTTAGCAGTAACCTC	mesoderm
ATACCTTTCCTGGGAC	proliferating progenitors
ATAGAGAGTGAGGAAA	 keratocytes II
ATCAGGTAGTGCGCTC	 keratocytes I
ATCCACCTCATAGACC	 keratocytes I
ATCCATTCACAATTCG	 keratocytes I
ATCCATTTCCCATTTA	neural crest
ATCCCTGCAAAGCTCT	 keratocytes I
ATCCGTCTCCTCACCA	neural crest
ATCCTATGTACTCGAT	 keratocytes I
ATCCTATGTTCCTTGC	 keratocytes I
ATCGGCGTCTTGGATG	mesoderm
ATCTCTAGTAGGACTG	neural crest
ATCTCTAGTGACAGCA	neural crest
ATCTTCAAGTCGAAAT	 keratocytes I
ATCTTCAGTGAGCCAA	 keratocytes I
ATGAAAGTCCATTCGC	neural crest
ATGAGGGAGTTGAAGT	 keratocytes I
ATGCGATAGGCGACAT	neural crest
ATGCGATTCGAGCCTG	 keratocytes I
ATGGAGGGTGCATTTG	 keratocytes II
ATGGATCCACTGCACG	mesoderm
ATGGGTTAGCAAACAT	 keratocytes I
ATGTCCCCAACAGCCC	neural crest
ATTACCTAGAAAGTCT	 keratocytes I
ATTACCTGTGAGCCAA	 keratocytes I
ATTACTCGTGAGTAAT	 keratocytes I
ATTCAGGAGACTGTTC	mesoderm
ATTCGTTTCTCATGGA	neural crest
ATTGGGTTCAAGCCGC	mesoderm
ATTTACCTCCAAATGC	neural crest
ATTTCACGTTTACTGG	neural crest
CAAAGAATCCATAAGC	proliferating progenitors
CAACAGTAGGTCATAA	mesoderm
CAACAGTAGGTCGTCC	 keratocytes I
CAACAGTCAGCGTGAA	 keratocytes I
CAACCAAAGACATCAA	neural crest
CAACCTCAGATCACTC	neural crest
CAACCTCCAATGAAAC	neural crest
CAACGATCAGGACATG	neural crest
CAACGGCAGCCTTGAT	neural crest
CAAGAGGAGACTTCGT	proliferating progenitors
CAATACGGTGCGAGTA	neural crest
CAATCGACAAGCTGCC	 keratocytes I
CACACAACAGCACGAA	mesoderm
CACACAAGTAGATTAG	proliferating progenitors
CACAGATCATGGCCAC	 keratocytes II
CACAGGCGTTGAATCC	neural crest
CACAGGCTCAGCCTCT	mesoderm
CACCAAATCATGAAAG	neural crest
CACCGTTAGCTCTATG	neural crest
CACGAATAGGGCCCTT	conjunctival epithelium
CACGTGGCACTGCACG	neural crest
CACGTTCAGGCATTTC	 keratocytes I
CACTGAAGTCAACGCC	mesoderm
CACTTCGTCTTCGATT	 keratocytes I
CAGAGCCGTACTTGTG	 keratocytes I
CAGATACGTTGTTGCA	 keratocytes I
CAGATCAAGGCTATCT	 keratocytes I
CAGCGTGCACCTGTCT	neural crest
CAGGCCATCGCTTAAG	neural crest
CAGTGCGCAAATTGGA	 keratocytes I
CAGTGCGCATCGTGGC	 keratocytes I
CAGTTCCTCCATCACC	neural crest
CATAAGCGTAATTAGG	 keratocytes I
CATACCCGTAAGCTCT	proliferating progenitors
CATCCCATCTGCTTAT	mesoderm
CATCCGTCAACCGATT	 keratocytes I
CATCGGGCAAATGAAC	neural crest
CATCGGGGTTGCGAAG	 keratocytes I
CATCGTCCATCGAGCC	neural crest
CATGCAAAGAAGTGTT	neural crest
CATGCAACAGCCGTCA	 keratocytes I
CATGCCTGTTTCACTT	neural crest
CATGCTCCATGCCGGT	neural crest
CATGGATCATAAGCAA	 keratocytes I
CATGGTAGTACACGCC	 keratocytes I
CATTGAGGTTACGGAG	neural crest
CATTGCCGTACGGGAT	 keratocytes I
CCAAGCGAGTGGATTA	 keratocytes I
CCAATGAAGTGAGTGC	 keratocytes I
CCAATTTGTTTACACG	mesoderm
CCACAAACACTCTGCT	neural crest
CCACACTGTTCGGCGT	 keratocytes I
CCACGAGTCTTCCCAG	neural crest
CCACGTTTCGGAGTAG	neural crest
CCCAACTCAGGGATAC	neural crest
CCCATTGAGTAGGAAG	neural crest
CCCGGAAAGGCTCCCA	neural crest
CCCTCTCTCTCGTGAA	neural crest
CCCTGATGTTTCGACA	proliferating progenitors
CCCTTAGCAAGTCCCG	neural crest
CCCTTAGTCATTTGGG	endothelium
CCGAACGTCTTCTGTA	mesoderm
CCGATCTGTGGATGAC	 keratocytes I
CCGATCTTCTTTGCTA	mesoderm
CCGGGTACACTGTTCC	neural crest
CCGGGTAGTAACAGTA	neural crest
CCGTAGGCAACGTATC	neural crest
CCGTAGGGTAGGTAGC	 keratocytes I
CCTACGTAGGCAGGGA	neural crest
CCTACGTGTATAGCTC	 keratocytes I
CCTACGTTCGGATTAC	neural crest
CCTCCTCGTATTTCTC	 keratocytes I
CCTCCTCGTCATCTAG	 keratocytes I
CCTCTAGAGTAAGGGA	 keratocytes I
CCTCTAGCACACCTGG	 keratocytes II
CCTGCATAGTGCGCTC	 keratocytes I
CCTGCATCAGACACCC	neural crest
CCTGTTGGTAGTTCCA	 keratocytes I
CCTTCAGTCAGACATC	 keratocytes I
CGAAGGAAGTTTCAGC	 keratocytes I
CGAAGGATCTAGAGCT	neural crest
CGAATTGCATAACCCA	mesoderm
CGAATTGGTATCCTTT	mesoderm
CGACAGCAGTCGCCAC	neural crest
CGAGGAAAGTATGCAA	 keratocytes I
CGCATGGGTACAGTTC	proliferating progenitors
CGCCAGAGTGCTCCGA	neural crest
CGCCATTAGGGCCTCT	 keratocytes I
CGGACACTCCGAGCTG	neural crest
CGGGACTCATTCCTAT	 keratocytes I
CGGGCATGTTCAAGTC	neural crest
CGGGTCATCATGAGGG	conjunctival epithelium
CGGGTCATCCCTCAAC	conjunctival epithelium
CGTAAGTGTCACGCTG	neural crest
CGTAATGCAACTGAAA	 keratocytes I
CGTGAATAGTGACCTT	neural crest
CGTGAATCAACCACAT	 keratocytes I
CGTTGGGGTATCGAGG	neural crest
CGTTGGGTCATCCCGT	neural crest
CGTTGGGTCCACACCT	 keratocytes I
CTAACCCGTGATCGTT	neural crest
CTAACTTTCAGAATAG	neural crest
CTACCTGTCTGGGTCG	 keratocytes I
CTACGGGCAGGAATCG	mesoderm
CTACTATAGGTTACAA	neural crest
CTACTATTCACGATAC	mesoderm
CTAGGTAGTACACGCC	 keratocytes I
CTATCCGGTATTGGCT	proliferating progenitors
CTCAGAACACGGGTAA	 keratocytes I
CTCAGAATCATTCGGA	 keratocytes I
CTCAGAATCTACTCAT	neural crest
CTCAGGGTCCATCTCG	mesoderm
CTCATCGGTCCAGAAG	neural crest
CTCCACACAAAGAGTT	 keratocytes I
CTCCACACACAGCTGC	neural crest
CTCCCTCCATGGAATA	 keratocytes I
CTCCCTCTCTTCGTAT	 keratocytes I
CTCCGATAGGTTAAAC	proliferating progenitors
CTCCGATGTGACTCTA	neural crest
CTCCTCCAGGGACCAT	 keratocytes I
CTCCTTTAGGAGGGTG	 keratocytes I
CTCCTTTCAATTGAAG	neural crest
CTCGAGGGTCCGGTCA	mesoderm
CTCTCGAAGGAGCAAA	neural crest
CTGAATGCAGGACGAT	 keratocytes I
CTGAGCGAGAAATGGG	neural crest
CTGAGCGCAGCAAGAC	mesoderm
CTGAGGCCACTTGAGT	neural crest
CTGATCCGTGGAGGTT	neural crest
CTGCAGGTCTCTGCTG	neural crest
CTGCCATAGTCAGCGA	 keratocytes II
CTGCCATCATCCCACT	neural crest
CTGCGAGCACCCAACG	 keratocytes I
CTGCGAGCACGTTGGC	 keratocytes I
CTGGACGAGGAAACGA	conjunctival epithelium
CTGGACGGTCCTATAG	mesoderm
CTGGTCTTCGTAGGGA	 keratocytes I
CTGTCGTGTCTACATG	 keratocytes I
CTGTCGTTCCGTAGGC	neural crest
CTGTGAAGTCATAGTC	 keratocytes II
CTGTGGGCAAGTGCAG	neural crest
CTGTGGGCAGGCAATG	neural crest
CTGTGGGTCTCCCTAG	neural crest
CTTACCGGTTCGGTCG	mesoderm
CTTCGGTGTACAGTCT	neural crest
CTTCGGTGTTCTCGTC	 keratocytes I
CTTGAGATCGCGTAGC	 keratocytes I
CTTTCAAGTGGGTCAA	mesoderm
GAAATGACATCGATGT	proliferating progenitors
GAAATGATCTGGTGCG	 keratocytes I
GAACTGTGTGGACTAG	 keratocytes I
GAAGAATGTATCACCA	 keratocytes I
GAAGAATGTCTGTGTA	neural crest
GAAGCGACATGATAGA	 keratocytes I
GAAGCGATCCGTGGCA	 keratocytes II
GAAGGACAGCTTAAGA	 keratocytes I
GAAGGGTTCGCTATTT	neural crest
GAAGTAAAGCCTATTG	neural crest
GACATCACAGGTTACT	mesoderm
GACCCAGGTTAGTCGT	neural crest
GACCTTCCAGAACTTC	 keratocytes I
GACCTTCGTACTAGCT	neural crest
GACGCTGGTAATCAAG	neural crest
GACTGATGTTAACCTG	 keratocytes I
GACTTCCTCTCACCCA	neural crest
GACTTCCTCTTCGATT	 keratocytes I
GAGAAATAGTAGGGTC	proliferating progenitors
GAGAAATCAACTTGCA	neural crest
GAGAAATGTTGGGACA	 keratocytes II
GAGAAATTCGACACCG	 keratocytes I
GAGACTTAGCAATAAC	neural crest
GAGAGGTTCACGAACT	neural crest
GAGCTGCGTGTCCAAT	proliferating progenitors
GAGGCAACATGTCAGT	 keratocytes I
GAGGGTAGTAACACGG	neural crest
GAGGGTATCTGAGAAA	 keratocytes I
GAGTCATTCTCCTACG	 keratocytes I
GAGTGAGTCGATGGAG	 keratocytes I
GAGTGTTTCACTGTTT	 keratocytes I
GAGTGTTTCAGATTGC	 keratocytes I
GAGTTACGTGCTCCGA	neural crest
GAGTTGTCAAGCGCTC	neural crest
GAGTTTGGTCGCTTAA	neural crest
GATAGAAGTGGAAGTC	neural crest
GATCACATCCCTCTAG	 keratocytes I
GATGCTACACTCACTC	neural crest
GATTCGAGTCCAAAGG	 keratocytes I
GATTCTTCACCCTGAG	 keratocytes I
GATTGGTTCAAAGGTA	neural crest
GCAACCGCAGACCAAG	neural crest
GCACTAACAGAACCGA	 keratocytes I
GCAGCTGGTCACTGAT	neural crest
GCAGCTGGTCCGGTCA	mesoderm
GCATCTCCAGGATCTT	corneal epithelium
GCATTAGGTGTGATGG	neural crest
GCCAACGAGGCCACTC	neural crest
GCCAGCAGTCGAGATG	mesoderm
GCCAGGTGTCATCACA	mesoderm
GCCAGGTGTCCAAATC	neural crest
GCCATGGAGATACATG	proliferating progenitors
GCCCGAATCCACGGGT	neural crest
GCCTGTTGTCTACATG	mesoderm
GCGAGAAGTGCGGATA	neural crest
GCGTTTCCATTGAAAG	neural crest
GCTACAACAACCGATT	 keratocytes I
GCTCAAACACCAAAGG	 keratocytes I
GCTCAAATCGCAGTTA	neural crest
GCTGCAGCAGCTACCG	neural crest
GCTTGGGAGGAACATT	mesoderm
GCTTGGGGTCTAACGT	neural crest
GGAACCCAGGTGCATG	neural crest
GGAAGTGTCAGTCCGG	 keratocytes I
GGAATGGTCGCCAATA	 keratocytes I
GGAGATGTCTTAAGGC	neural crest
GGAGCAAAGGCACAAC	neural crest
GGATCTATCACCATAG	 keratocytes II
GGCACGTTCGAAGCCC	 keratocytes I
GGCAGTCAGGAAGTCC	 keratocytes I
GGCGTCAGTAATTGGA	 keratocytes I
GGCTTGGAGACAGCTG	 keratocytes I
GGCTTGGCAACACTAC	 keratocytes I
GGCTTTCCAACGGGTA	 keratocytes I
GGGAAGTGTTCTTAGG	neural crest
GGGACAATCCTGTTAT	neural crest
GGGACCTTCCAGTGCG	neural crest
GGGAGATTCATGAGTC	neural crest
GGGAGATTCTCAGTCC	 keratocytes I
GGGATCCCAGGGTCTC	 keratocytes I
GGGATGACATAGGCGA	neural crest
GGGCCATCACCTTCCA	 keratocytes I
GGGCCATTCTCATGGA	neural crest
GGGCTCAGTGGCAGAT	neural crest
GGGTCACAGGCGCTCT	 keratocytes II
GGGTCACGTATCGTGT	 keratocytes I
GGGTCTGCAGCTGTAT	 keratocytes I
GGGTGAAAGGCCTAAG	 keratocytes I
GGGTGAATCGCAGATT	neural crest
GGGTTTAAGGCGAACT	neural crest
GGTAACTAGTTCCTGA	mesoderm
GGTAACTCAGGGAGAG	mesoderm
GGTAATCGTTGTCAGT	 keratocytes I
GGTCACGCACCAGACC	neural crest
GGTGAAGCACGCGGTT	 keratocytes II
GGTGATTAGCCGAACA	neural crest
GGTGGCTCAGTTCACA	 keratocytes I
GGTGTTATCATGGATC	 keratocytes II
GGTTCTCCAGCTACTA	neural crest
GGTTCTCCATCCGAGC	neural crest
GTAACACGTACGATGG	neural crest
GTAAGTCCACTATCGA	neural crest
GTAATGCGTTCCACAA	neural crest
GTAGAAACACGTCTCT	 keratocytes II
GTAGAAACAGTCTACA	 keratocytes I
GTAGAGGCATCCAATG	neural crest
GTAGCTAGTGTGAGCA	neural crest
GTAGGAGAGCTGAAAT	neural crest
GTAGGAGTCGACATTG	 keratocytes I
GTATTTCTCCCTCTCC	neural crest
GTCAAACAGTTCTACG	proliferating progenitors
GTCACTCCAGTCGAGA	mesoderm
GTCACTCGTAACACCT	 keratocytes I
GTCATGATCAGACTGT	neural crest
GTCATTTCACTAGGCC	 keratocytes I
GTCATTTGTGCGTGCT	 keratocytes I
GTCCACTCACTGGAAG	neural crest
GTCGTTCAGTTGGCTT	mesoderm
GTCGTTCCACGGAAGT	neural crest
GTCGTTCCAGCTTCGG	 keratocytes I
GTCTACCCAACATCGT	neural crest
GTGAGCCCATCTGGGC	mesoderm
GTGAGGATCCCTCTAG	 keratocytes I
GTGCACGGTGACGCCT	corneal epithelium
GTGCAGCGTTCAACGT	neural crest
GTGCAGCTCCTAGAGT	 keratocytes II
GTGCTGGTCAATCCAG	 keratocytes I
GTGGAAGCATCGAACT	neural crest
GTGGAAGTCAGAGTGG	mesoderm
GTGGCGTAGTTGAAAC	neural crest
GTGGGAATCGAGAGCA	 keratocytes I
GTGGGAATCGCCGATG	neural crest
GTGGTTACAGATCCTA	 keratocytes I
GTGGTTATCAATCTCT	neural crest
GTGTCCTCACATGACT	neural crest
GTGTCCTGTAGAGCTG	 keratocytes I
GTGTGATTCACCATAG	 keratocytes I
GTTACAGTCCGACAGC	neural crest
GTTACGACACCTCTGT	 keratocytes I
GTTAGTGGTCCGTACG	 keratocytes I
GTTCATTGTTTGAACC	neural crest
GTTCTATCACAGCCTG	 keratocytes I
GTTCTATTCACAAGAA	neural crest
GTTGAACAGTTTGGCT	neural crest
GTTGCTCAGGAACGAA	mesoderm
GTTGCTCCATCAGCTA	neural crest
GTTGTCCTCACACCGG	neural crest
TAACTTCAGTACCGGA	neural crest
TAACTTCCAAACTGCT	neural crest
TAAGCACCAAGAGTGC	neural crest
TAAGCACTCCAGGACC	neural crest
TAAGCCACAAGCCCAC	neural crest
TACAACGCAGTGCCTG	neural crest
TACACCCGTTGGACTT	neural crest
TACCCGTAGAGCAACC	 keratocytes I
TACCGGGAGGTCATAA	neural crest
TACCTCGGTACTGAGG	neural crest
TACCTGCGTTGTGCAT	 keratocytes I
TACGCTCGTAGGACCA	 keratocytes I
TACGCTCTCCGGTTCT	endothelium
TACGGTAAGAACGTGC	 keratocytes I
TACGGTACATTGTGCA	 keratocytes I
TACTTACTCGATGCAT	neural crest
TAGAGTCTCCGGTTCT	 keratocytes I
TAGATCGTCCTTTAGT	neural crest
TAGGAGGGTACTGCGC	endothelium
TAGGTACAGTCGAATA	 keratocytes I
TAGGTACGTTCAGCGC	 keratocytes I
TAGGTTGAGCTGACAG	conjunctival epithelium
TATACCTAGGTAAAGG	mesoderm
TATACCTGTACTCAAC	neural crest
TATCAGGCACCAACAT	 keratocytes I
TATTCCAGTTGCGGAA	mesoderm
TATTTCGCAATGAACA	mesoderm
TCAAGCATCAAGAGGC	neural crest
TCAATTCAGTCTTCGA	 keratocytes I
TCACAAGCACTTCTCG	 keratocytes I
TCACAAGGTCTCGGGT	 keratocytes I
TCACGCTTCCAACTAG	mesoderm
TCACGCTTCGTGCGAC	neural crest
TCACTATGTACAAACA	 keratocytes I
TCACTCGAGGCTTCCG	neural crest
TCACTCGCAAGTGTCT	neural crest
TCAGCAAAGTATAGGT	proliferating progenitors
TCAGCCTAGAGAGGTA	neural crest
TCAGCCTTCATAGCAC	mesoderm
TCAGGTACAATACGAA	neural crest
TCAGGTACACTGAGTT	neural crest
TCAGTGAAGGCTCACC	neural crest
TCATGAGTCAATGTCG	mesoderm
TCATGGAGTATCGTGT	mesoderm
TCATGTTCAAGTGGCA	neural crest
TCATTACAGCATGAAT	mesoderm
TCATTACAGGTTCTAC	 keratocytes I
TCATTTGGTTATGGTC	 keratocytes I
TCCACCACAGCAGTTT	mesoderm
TCCATCGTCAGGGTAG	neural crest
TCCATGCGTAGAGTTA	 keratocytes II
TCCCACAAGCCGTCGT	conjunctival epithelium
TCCCAGTTCTCTGCTG	 keratocytes I
TCCGGGACAACGGGTA	 keratocytes I
TCCGGGACAGACAAAT	neural crest
TCCTAATTCAGACAAA	neural crest
TCCTAATTCGTTTACT	 keratocytes I
TCCTGCAGTAGACTGG	neural crest
TCCTTCTCAACGGCTC	neural crest
TCCTTCTTCATAAGGA	neural crest
TCCTTTCAGAGGGTAA	 keratocytes II
TCCTTTCAGTCCGCCA	 keratocytes I
TCGACCTCAGATCATC	neural crest
TCGCAGGCATCACGGC	neural crest
TCGGGACAGTGATAAC	 keratocytes I
TCGGTCTTCTGAGATC	 keratocytes I
TCGTAGATCCCGAAAT	mesoderm
TCGTCCAGTCTCGGGT	neural crest
TCGTGCTAGTGATAAC	neural crest
TCGTGCTTCATACGAC	 keratocytes I
TCGTGGGCAACACACT	 keratocytes I
TCTACATAGAATCGCG	 keratocytes I
TCTCTGGGTACCCAGC	neural crest
TCTGCCAAGCAATAGT	 keratocytes I
TGAACGTCAAATGCTC	neural crest
TGAACGTGTTTGTTCT	neural crest
TGACAGTTCCTTTGAT	neural crest
TGACCCTCACAAACGG	neural crest
TGACCCTCACCACATA	neural crest
TGACCCTGTACGATGG	neural crest
TGACGCGCAGGAAGTC	 keratocytes I
TGAGACTGTGGCGCTT	neural crest
TGAGGGAGTCGTGGAA	mesoderm
TGAGGTTGTACCACGC	neural crest
TGATCTTAGAAATCCA	neural crest
TGATCTTGTTGGCCGT	neural crest
TGATTTCTCCATCCGT	 keratocytes I
TGCACGGGTGTTGATC	 keratocytes I
TGCACGGTCTCGGGAC	neural crest
TGCAGGCTCCCTCTCC	neural crest
TGCAGGCTCGTAGGGA	 keratocytes I
TGCAGTATCATTCATC	neural crest
TGCATCCAGATCGGTG	 keratocytes I
TGCATGATCAAGCTTG	neural crest
TGCGGCAAGAATCGAT	 keratocytes I
TGCTCCATCTGAGAGG	 keratocytes I
TGCTCGTTCGCTATTT	neural crest
TGCTTCGAGGAACATT	 keratocytes I
TGGAACTAGATCCTAC	neural crest
TGGAGGAAGAGCAACC	neural crest
TGGATCAAGCTGTGCC	neural crest
TGGATCAGTGTGTCCG	neural crest
TGGATCATCATCTGTT	 keratocytes I
TGGGATTGTAGATGTA	 keratocytes I
TGGGATTTCACCGACG	neural crest
TGGGCTGCACAGAGAC	 keratocytes I
TGGGTTAAGGAACGCT	 keratocytes I
TGGTGATAGAGTACCG	 keratocytes II
TGTAACGCATATCTGG	 keratocytes I
TGTAACGTCCAACTGA	mesoderm
TGTAAGCAGAGATTCA	 keratocytes I
TGTCAGAAGAGAGGGC	 keratocytes I
TGTCAGAGTAGGACCA	 keratocytes I
TGTGAGTCATGCGGTC	proliferating progenitors
TGTGATGGTGTCCCTT	 keratocytes I
TGTGCGGCAATGTGGG	 keratocytes I
TGTGCGGGTAACATCC	 keratocytes I
TGTGGCGTCAACTACG	proliferating progenitors
TGTTCATAGGTGCTAG	neural crest
TGTTCATGTGACCGAA	neural crest
TGTTCTAGTTCCCACT	neural crest
TGTTTGTGTATCATGC	neural crest
TGTTTGTTCCAACTAG	neural crest
TTAATCCGTCAGTTTG	neural crest
TTACAGGCACCCAACG	 keratocytes I
TTACCGCGTGATGTAA	mesoderm
TTACCGCTCGGTTGTA	neural crest
TTACGTTAGGAAAGAC	 keratocytes I
TTAGTCTCAGCTTTGA	mesoderm
TTCACGCTCTTCGCTG	 keratocytes II
TTCAGGAGTCGGCACT	neural crest
TTCATTGGTTGGGATG	neural crest
TTCCACGCACCCGTAG	 keratocytes I
TTCCGTGAGCCAGTAG	proliferating progenitors
TTCCGTGAGGACACTG	neural crest
TTCCGTGTCATCCTAT	 keratocytes I
TTCTAGTCAGGGACTA	mesoderm
TTCTGTAAGATGCCGA	 keratocytes I
TTGAGTGAGAATTGCA	neural crest
TTGAGTGTCCGAAATC	 keratocytes I
TTGATGGAGGTTCATC	 keratocytes I
TTGCCTGCAGAACTAA	 keratocytes I
TTGCCTGGTAGCTGTT	neural crest
TTGCCTGGTGATTCAC	 keratocytes I
TTGCGTCCATTACTCT	neural crest
TTGGATGGTGATCGTT	 keratocytes II
TTGGGATCAGGCTTGC	neural crest
TTGGGCGGTGCCAAGA	neural crest
TTGTGGAAGTAACCTC	mesoderm
TTGTGGATCCGTCACT	neural crest
TTGTGTTAGTTGCTGT	 keratocytes I
TTGTGTTTCTTCTGTA	 keratocytes I
TTGTTTGGTATGAGAT	neural crest
TTTACCAAGCTAAGTA	 keratocytes I
TTTACGTGTACGAGTG	neural crest
TTTACGTTCATTCTTG	 keratocytes I
TTTAGTCTCAGCAATC	 keratocytes I
TTTATGCGTAACGTTC	neural crest
TTTCATGTCACTGAAC	neural crest
TTTCCTCAGGATTTGA	mesoderm
TTTCCTCGTCTACTGA	 keratocytes I
TTTCGATAGTCGAGGT	 keratocytes I
TTTCGATCACCCTGAG	 keratocytes I
TTTGACTCAACGGTAG	neural crest
TTTGGTTCAGGTTCCG	conjunctival epithelium
TTTGGTTGTCACTACA	neural crest
TTTGGTTTCTGCCCTA	mesoderm
TTTGTTGTCATCCCGT	 keratocytes I
AAACCCACAACTCGTA	endothelium
AAAGGATAGCTTTCCC	neural crest
AAAGGTAGTGTGAGCA	endothelium
AAAGGTATCGACGCGT	endothelium
AAAGTCCCACACTGGC	proliferating progenitors
AACACACAGACTGGGT	proliferating progenitors
AACAGGGAGCAACTCT	corneal epithelium
AACCAACCACCTCTAC	conjunctival epithelium
AACCACAGTTTGTGGT	corneal epithelium
AACCCAAAGCTTTCTT	neural crest
AACGAAACATCGATAC	neural crest
AACGGGAAGTTTGAGA	endothelium
AACGGGAGTTGGGTTT	neural crest
AACTTCTGTAACATAG	 keratocytes II
AACTTCTTCCTCACCA	 keratocytes I
AAGAACACAAGCCTGC	neural crest
AAGGAATAGACCCTTA	conjunctival epithelium
AAGGAATAGGGACTGT	 keratocytes I
AAGTTCGTCCAACCGG	neural crest
AATAGAGAGTTTGAGA	conjunctival epithelium
AATAGAGCAAGAGTGC	corneal epithelium
AATCACGCATAGACTC	conjunctival epithelium
AATCGACTCGTTCCCA	conjunctival epithelium
AATCGTGAGTGAATAC	corneal epithelium
AATCGTGAGTGACCTT	neural crest
AATCGTGCAGTGTGGA	neural crest
AATGAAGGTTGTCATG	neural crest
AATGCCAGTATCAAGA	conjunctival epithelium
AATTTCCAGAGAGTGA	corneal epithelium
AATTTCCTCTATACTC	corneal epithelium
ACAAGCTAGCCAGTAG	corneal epithelium
ACACAGTAGTATCTGC	neural crest
ACACCAAGTCTCGGAC	corneal epithelium
ACACCAATCTCTGCTG	endothelium
ACACGCGGTACGGTTT	proliferating progenitors
ACACTGATCTCTAGGA	corneal epithelium
ACACTGATCTTGATTC	corneal epithelium
ACAGAAATCATTACGG	neural crest
ACAGCCGGTCGACGCT	neural crest
ACATCGACAATGCAAA	corneal epithelium
ACCACAAAGATACCAA	conjunctival epithelium
ACCATTTGTACAGAGC	corneal epithelium
ACCCAAAAGGTTCATC	neural crest
ACCCAAAGTGCCAAGA	corneal epithelium
ACCCTCATCGTTCAGA	corneal epithelium
ACCTGTCAGTTTCGAC	corneal epithelium
ACGATCATCCAGTTCC	endothelium
ACGATGTTCGTCGCTT	neural crest
ACGGTCGCAGGCTCTG	 keratocytes II
ACGGTTAGTGAGCCAA	neural crest
ACGGTTAGTTCAAACC	neural crest
ACGTAACCAAGAGAGA	neural crest
ACGTACAGTACTTCCC	neural crest
ACGTTCCAGACATACA	neural crest
ACTACGAGTAGAAACT	corneal epithelium
ACTATCTAGATGCTTC	 keratocytes I
ACTATCTCAAGCAATA	corneal epithelium
ACTGATGCACATACTG	neural crest
ACTTAGGGTTCCACAA	mesoderm
ACTTATCAGCATAGGC	mesoderm
ACTTATCGTGGCTACC	corneal epithelium
ACTTCGCAGCCGTTAT	neural crest
ACTTTCACATACCAGT	corneal epithelium
AGAACAAGTGTGATGG	endothelium
AGAACCTTCTGAGGTT	conjunctival epithelium
AGAAGCGGTACCGTCG	neural crest
AGAAGTAAGAGTGAAG	corneal epithelium
AGAAGTACATCTTCGC	neural crest
AGACAAATCTGGCCTT	neural crest
AGAGAATGTAAGAACT	conjunctival epithelium
AGAGAATGTCTTACTT	conjunctival epithelium
AGAGCAGCACCCAAGC	corneal epithelium
AGAGCCCCACACCGCA	endothelium
AGATAGAAGTAGGTTA	conjunctival epithelium
AGATCCATCGACGTCG	neural crest
AGATGAAAGGCCTTCG	corneal epithelium
AGATGAACAATCTCGA	neural crest
AGATGAAGTGACCTGC	conjunctival epithelium
AGCCAATCACGCGCTA	neural crest
AGCCAATGTTAAGGGC	corneal epithelium
AGCCACGAGTGGATTA	conjunctival epithelium
AGCGATTAGTCCGCCA	neural crest
AGCTTCCAGAGTCCGA	neural crest
AGGAAATCACAGTATC	neural crest
AGGACGAGTTAGGCTT	endothelium
AGGAGGTCACACCGAC	endothelium
AGGAGGTTCCCGATCT	neural crest
AGGATCTTCTGGTGCG	endothelium
AGGCTGCTCCATTTGT	conjunctival epithelium
AGGGAGTAGTGCCGAA	conjunctival epithelium
AGGGAGTTCTTCTAAC	neural crest
AGGTCTAAGGACGCTA	endothelium
AGTACCAGTTAGGGTG	corneal epithelium
AGTACCATCAATCAGC	neural crest
AGTACCATCACTCACC	neural crest
AGTACTGAGTACGAGC	neural crest
AGTACTGGTAATCAAG	neural crest
AGTACTGGTAGAGCTG	neural crest
AGTAGCTAGTTAACGA	proliferating progenitors
AGTAGCTGTCGAAACG	neural crest
AGTCATGAGACTTGTC	corneal epithelium
AGTCATGAGCAAATCA	corneal epithelium
AGTGACTCAACGCCCA	neural crest
AGTGCCGTCGATACAC	corneal epithelium
AGTGTTGAGGAGGCAG	corneal epithelium
AGTGTTGGTAGGTGCA	conjunctival epithelium
AGTGTTGGTCACTTCC	corneal epithelium
AGTTCGACAATACAGA	neural crest
ATACCGACAAACCGGA	conjunctival epithelium
ATACTTCAGTGATAAC	corneal epithelium
ATACTTCGTCCACACG	endothelium
ATAGAGAGTCACGCTG	conjunctival epithelium
ATATCCTGTGAATTGA	 keratocytes I
ATCACGAAGATTCGCT	corneal epithelium
ATCACGAGTATGCTAC	corneal epithelium
ATCAGGTTCGCCATAA	conjunctival epithelium
ATCCACCCATAAGCGG	corneal epithelium
ATCCATTGTTCGGTCG	neural crest
ATCCTATGTGGTCTAT	neural crest
ATCGGATTCGTGTGAT	neural crest
ATCGTAGAGCAATTAG	neural crest
ATCGTGAAGACTTCCA	proliferating progenitors
ATCGTGACATGTTCGA	neural crest
ATCTCTAGTTAGGCTT	neural crest
ATGAAAGGTAGACACG	neural crest
ATGAGGGCATGCAGCC	 keratocytes I
ATGCATGCACCTAAAC	neural crest
ATGCGATTCACTCTTA	corneal epithelium
ATGGATCCACTCTGCT	corneal epithelium
ATGGGAGAGCCTCTCT	corneal epithelium
ATGTCCCCAAGATCCT	corneal epithelium
ATTACCTTCCTCTGCA	neural crest
ATTACTCCAGTGGCTC	corneal epithelium
ATTACTCCATTGCCGG	corneal epithelium
ATTACTCTCGCCTCTA	corneal epithelium
ATTCACTCACATCCCT	corneal epithelium
ATTCATCTCAAGTGGG	corneal epithelium
ATTCATCTCGAACGGA	conjunctival epithelium
ATTCCATAGACTTCGT	neural crest
ATTCCTAGTTGTACGT	corneal epithelium
ATTCGTTCACAACGCC	neural crest
ATTCTTGGTTCCGTTC	endothelium
ATTGGGTAGCACACAG	corneal epithelium
ATTTCTGGTAGGACCA	neural crest
ATTTCTGGTTCTCACC	 keratocytes II
CAACAACTCAAGGAGC	neural crest
CAACCAATCGTGGCGT	corneal epithelium
CAACCTCCAACAACAA	proliferating progenitors
CAACGGCGTGGTATGG	corneal epithelium
CAAGACTGTATAATGG	conjunctival epithelium
CAAGACTGTGCCTTTC	corneal epithelium
CAATACGTCGTTCCTG	corneal epithelium
CAATGACCACTACCCT	 keratocytes I
CAATTTCCAGTGTATC	corneal epithelium
CAATTTCGTTACGCCG	corneal epithelium
CACAACACACTTACAG	neural crest
CACCAAACATGGGAAC	corneal epithelium
CACCGTTTCCTCTTTC	proliferating progenitors
CACGAATTCCAAATGC	corneal epithelium
CACGAATTCGTTAGAC	corneal epithelium
CACGTTCGTTCCTTGC	corneal epithelium
CACTGGGGTGTCCACG	neural crest
CAGATCAAGTTGGACG	neural crest
CAGATCATCATGAGTC	neural crest
CAGATCATCCTCGATC	neural crest
CAGATTGAGATTGATG	neural crest
CAGATTGGTTGTTGTG	neural crest
CAGCAATCATCGTGGC	endothelium
CAGCGTGCATAGATCC	neural crest
CAGCGTGTCATAGCAC	neural crest
CAGGCCACACGCTATA	neural crest
CAGGGCTGTTCCAAAC	conjunctival epithelium
CAGTTAGAGGACAAGA	neural crest
CATACAGAGTTTCGGT	 keratocytes I
CATACAGGTCTGGTTA	neural crest
CATACTTAGTGGCGAT	neural crest
CATCAAGCAGGACAGT	corneal epithelium
CATCAAGGTGATCGTT	neural crest
CATCCACTCCGCTTAC	neural crest
CATCCCATCGAACGGA	corneal epithelium
CATCCGTTCTATCACT	neural crest
CATCGCTGTACCAATC	corneal epithelium
CATCGTCCAGTAGTTC	neural crest
CATGAGTAGTTGTACC	corneal epithelium
CATGCCTGTACTCGAT	corneal epithelium
CATGGATAGGTGCATG	corneal epithelium
CATGGTAAGTTGCTCA	conjunctival epithelium
CATTGCCCAGGATGAC	neural crest
CCAAGCGAGACTTCCA	corneal epithelium
CCAATGACAACGATCT	conjunctival epithelium
CCAATGACAGGTCAGA	conjunctival epithelium
CCACACTCAGAATCGG	endothelium
CCACACTTCACGTAGT	corneal epithelium
CCACCATAGAGTCTTC	endothelium
CCACTTGGTAGTCTTG	corneal epithelium
CCACTTGGTCGAAACG	neural crest
CCATCACTCTTGTTAC	corneal epithelium
CCCAACTCAAGTCATC	conjunctival epithelium
CCCAACTCAGTTAAAG	corneal epithelium
CCCTCAAAGTGGTTCT	neural crest
CCCTCAAGTACAAGCG	corneal epithelium
CCCTGATAGGTCACAG	corneal epithelium
CCGATGGCACGCCACA	corneal epithelium
CCGGACACAAGCTCTA	neural crest
CCGGGTAGTACCCGAC	endothelium
CCGGTAGAGCTGGAGT	corneal epithelium
CCGGTGAGTTTGGAAA	neural crest
CCGTAGGCAGTAGAGC	endothelium
CCGTGAGGTGTCCCTT	neural crest
CCGTTCAAGGCACGAT	corneal epithelium
CCTAACCCATCAGCGC	conjunctival epithelium
CCTAACCCATCAGTCA	conjunctival epithelium
CCTAAGACATCTGGGC	corneal epithelium
CCTAAGACATTGAGCT	corneal epithelium
CCTACGTCAGACAATA	conjunctival epithelium
CCTATCGAGGTTGACG	conjunctival epithelium
CCTCAACCACGAGGTA	neural crest
CCTCACATCCCTCGTA	neural crest
CCTCAGTGTCATAGTC	corneal epithelium
CCTCATGTCCCAAGTA	neural crest
CCTCTAGAGAAATTCG	neural crest
CCTCTCCGTCATTCCC	endothelium
CCTGTTGTCTGTCCGT	endothelium
CGAAGTTGTGGGACAT	corneal epithelium
CGAGAAGGTGAATGTA	proliferating progenitors
CGAGGAAGTTGGGACA	 keratocytes I
CGAGGCTTCGGAGATG	neural crest
CGAGTGCAGCGCAATG	corneal epithelium
CGAGTGCTCTGGGTCG	corneal epithelium
CGATGGCCAGAAGTTA	mesoderm
CGCAGGTTCGCATTGA	 keratocytes I
CGCCAGAGTACGTGTT	endothelium
CGCCATTCAGTCGTTA	corneal epithelium
CGGAACCGTTTCCAAG	neural crest
CGGACACGTAGACGGT	endothelium
CGGCAGTCATGTGTCA	conjunctival epithelium
CGGCAGTTCGTAGGGA	corneal epithelium
CGGGACTCACGACGTC	conjunctival epithelium
CGGGCATAGCATGGGT	conjunctival epithelium
CGGGCATCACCAGCTG	corneal epithelium
CGGGTGTAGATTGACA	endothelium
CGGTCAGTCTGTCGCT	neural crest
CGTCCATAGAGAGCCT	neural crest
CGTGATAGTAGAGCTG	neural crest
CGTGTCTAGCTGAGTG	neural crest
CTAACCCTCCCTGGTT	 keratocytes II
CTAACTTAGCAGCAGT	corneal epithelium
CTAACTTAGTTATGGA	neural crest
CTACATTCAGCGTTGC	corneal epithelium
CTACCCAAGCCGAATG	corneal epithelium
CTACTATGTGCATACT	neural crest
CTACTATGTGGTCCCA	endothelium
CTAGGTAAGCCATATC	conjunctival epithelium
CTATCTACATCGAACT	conjunctival epithelium
CTATCTATCTAGGCCG	conjunctival epithelium
CTCAACCGTAACGTTC	conjunctival epithelium
CTCAAGATCATTCCTA	endothelium
CTCAGAATCCTTCAGC	corneal epithelium
CTCAGTCTCATCGACA	corneal epithelium
CTCATCGCATCGTGCG	neural crest
CTCATGCCAATTGCCA	endothelium
CTCCACAAGTAACCGG	neural crest
CTCCACAGTGGCCTCA	neural crest
CTCCATGCAATCCTAG	corneal epithelium
CTCCATGGTTTATGCG	neural crest
CTCCCTCCAAACCACT	conjunctival epithelium
CTCCCTCGTTCGAACT	neural crest
CTCCGATCACCCTATC	neural crest
CTCCTTTCAATCTCTT	conjunctival epithelium
CTCCTTTCATTCGGGC	neural crest
CTGCCTATCTTTCAGT	conjunctival epithelium
CTGTACCTCACTGGTA	conjunctival epithelium
CTGTGAATCGCGTTTC	corneal epithelium
CTGTGGGAGGTAAACT	corneal epithelium
CTGTGGGGTGTCCATA	neural crest
CTTAGGATCTTTGATC	corneal epithelium
CTTCAATAGACCAAGC	endothelium
CTTCAATTCATACGAC	corneal epithelium
CTTCCTTCAGTAGTTC	 keratocytes I
CTTCTCTGTCATGGCC	endothelium
CTTGATTAGTTTCTTC	corneal epithelium
CTTTCAACACAGTACT	proliferating progenitors
CTTTCAAGTACCGTCG	neural crest
CTTTCAAGTGCGAACA	proliferating progenitors
GAAATGAGTCAAGCCC	proliferating progenitors
GAACGTTAGGTGGGTT	neural crest
GAACTGTTCTTCCGTG	conjunctival epithelium
GAAGGACTCCTCTAAT	endothelium
GAAGGGTCATAGAATG	corneal epithelium
GAAGTAAGTAGGAAAG	conjunctival epithelium
GAAGTAAGTCCTCATC	endothelium
GACATCACACCAGCTG	endothelium
GACCCTTTCGCTAAAC	neural crest
GACCGTGAGGTCATTC	 keratocytes I
GACCTTCAGCAAGCCA	corneal epithelium
GACGTTAGTGAGGATC	neural crest
GACTCAAAGTCTAGAA	corneal epithelium
GACTCAACACGCTGAC	corneal epithelium
GACTCTCAGGGTACGT	neural crest
GACTCTCCATTCCTAT	corneal epithelium
GACTGATAGCCGCTTG	neural crest
GACTGATTCATGGAGG	corneal epithelium
GAGAAATAGCCGATAG	corneal epithelium
GAGAGGTAGTGGCAGT	neural crest
GAGTCATAGCATCCCG	neural crest
GAGTCTAAGGTCCCGT	proliferating progenitors
GAGTCTATCCTTCGAC	neural crest
GAGTTACGTGCCTATA	neural crest
GAGTTTGGTACACGCC	proliferating progenitors
GATCACAAGTAGACAT	corneal epithelium
GATCACATCCTCACTG	endothelium
GATCAGTAGAATTGTG	corneal epithelium
GATCGTATCGTCCTCA	corneal epithelium
GATGACTGTACCGGCT	corneal epithelium
GATGACTGTCAGGAGT	corneal epithelium
GATGACTTCGCTAGCG	neural crest
GATGTTGAGAGTGTTA	corneal epithelium
GATTCGATCGTCTAAG	corneal epithelium
GATTCTTAGCGCCTAC	endothelium
GATTGGTCAAGCCCAC	 keratocytes I
GATTTCTGTTACTCAG	neural crest
GCACATACATGGCCAC	neural crest
GCACATATCACTACGA	neural crest
GCACGGTCAGAGTCAG	neural crest
GCACGGTGTACAAGCG	proliferating progenitors
GCAGCCACAGCATACT	endothelium
GCAGTTATCGCTCTAC	corneal epithelium
GCATCGGCAACCTAAC	corneal epithelium
GCCAACGCAATTGCCA	conjunctival epithelium
GCCAACGGTGCCCAGT	corneal epithelium
GCCAGGTGTATCGTAC	neural crest
GCCAGTGAGATTCGCT	neural crest
GCCAGTGAGTCCCTAA	conjunctival epithelium
GCCTGTTGTTCCCAAA	endothelium
GCCTGTTTCTACTGAG	 keratocytes II
GCGAGAACAGAACGCA	conjunctival epithelium
GCTACCTAGACCATGG	corneal epithelium
GCTACCTTCTGATTCT	corneal epithelium
GCTCAAATCCAACACA	neural crest
GCTGAATTCTGAGGTT	proliferating progenitors
GCTTCACCACTGAGTT	neural crest
GCTTGGGCAACTCGTA	corneal epithelium
GCTTGGGGTTTCAGAC	endothelium
GCTTGGGTCCTACAAG	conjunctival epithelium
GCTTTCGTCCAACTGA	 keratocytes I
GCTTTCGTCCGTCAAA	corneal epithelium
GGAACCCAGAAGATCT	corneal epithelium
GGAACCCTCATTCACT	neural crest
GGACGTCCACCAGTTA	neural crest
GGAGAACTCATGAGTC	neural crest
GGAGATGAGCGACCCT	corneal epithelium
GGAGATGGTACGGGAT	corneal epithelium
GGATCTAAGGATTCAA	endothelium
GGATGTTGTTCATCTT	neural crest
GGATGTTTCTAGTTCT	corneal epithelium
GGCTTGGGTCGTATGT	neural crest
GGGACCTAGTATTCCG	corneal epithelium
GGGACCTCAGAAATCA	proliferating progenitors
GGGACTCCACGTCTCT	neural crest
GGGAGTAAGTAAGCAT	endothelium
GGGAGTAGTCGAATTC	endothelium
GGGATGAAGAGGATCC	neural crest
GGGCCATTCGGAATGG	conjunctival epithelium
GGGTAGAAGTTAACAG	corneal epithelium
GGTCACGAGATGACCG	conjunctival epithelium
GGTCACGAGCTCTTCC	corneal epithelium
GGTCTGGGTCGATGCC	corneal epithelium
GGTGGCTGTGGTCTGC	 keratocytes I
GGTGTCGAGTTAGTGA	neural crest
GTAACACGTGCCCGTA	 keratocytes II
GTAACACTCCATCCGT	neural crest
GTAACCATCATGGCCG	endothelium
GTAATGCTCACACGAT	corneal epithelium
GTACAGTGTACAACGG	neural crest
GTAGAAAGTGATTGGG	neural crest
GTAGAGGGTGTGTACT	neural crest
GTAGCTAAGGATTTAG	neural crest
GTAGCTATCAGCGCGT	neural crest
GTAGTACGTCTGCGCA	endothelium
GTAGTACTCGTAGGAG	corneal epithelium
GTATTTCTCCGTCACT	proliferating progenitors
GTCAAACCATAACAGA	neural crest
GTCACGGTCATGCATG	neural crest
GTCATTTCAGGTATGG	conjunctival epithelium
GTCTCACGTTCAGCGC	corneal epithelium
GTCTCACTCGTTCTGC	corneal epithelium
GTCTGTCCACCATATG	corneal epithelium
GTCTGTCGTTTAGTCG	neural crest
GTGACGCGTTGCGAAG	corneal epithelium
GTGAGCCCAACCGGAA	neural crest
GTGAGGATCGTTGTAG	conjunctival epithelium
GTGCACGAGCAAGTCG	proliferating progenitors
GTGCTGGCACTGTCGG	neural crest
GTGGGAATCCATATGG	neural crest
GTGGTTACAGAATGTA	corneal epithelium
GTGGTTAGTTAGAGTA	proliferating progenitors
GTGTCCTCATGTTACG	conjunctival epithelium
GTGTGATGTGGGCTTC	corneal epithelium
GTGTGATTCTACCCAC	corneal epithelium
GTGTTAGCAGCAGAAC	corneal epithelium
GTTACAGAGTTACGGG	mesoderm
GTTAGACCAAACCACT	conjunctival epithelium
GTTAGACCATTGCTTT	corneal epithelium
GTTAGTGAGCAGCCCT	endothelium
GTTCATTCACTGAATC	corneal epithelium
GTTCATTCATCACGGC	conjunctival epithelium
GTTCCGTCAGCAGACA	neural crest
GTTCGCTAGCTGACAG	endothelium
GTTGCTCAGGCTGTAG	neural crest
GTTGTCCAGTTTGTCG	corneal epithelium
GTTGTGATCAAGGTGG	corneal epithelium
GTTTACTAGTTGGAGC	neural crest
GTTTACTGTGCATGTT	endothelium
TAACACGCATAATCCG	endothelium
TAACCAGAGTAACAGT	neural crest
TAACGACGTCACAGAG	endothelium
TAACGACGTTTGAAAG	 keratocytes I
TAACTTCAGCGTTACT	neural crest
TAACTTCCAACTCCAA	proliferating progenitors
TAAGCACGTATGTCTG	 keratocytes I
TAAGCGTAGCCTGACC	conjunctival epithelium
TAATCTCCACGAGGTA	corneal epithelium
TAATCTCTCACTTTGT	proliferating progenitors
TAATTCCAGACTTCGT	corneal epithelium
TAATTCCTCACAGAGG	neural crest
TACACCCAGATTGCGG	endothelium
TACACCCCAAATAGCA	mesoderm
TACACCCGTTTGAACC	conjunctival epithelium
TACACCCTCTCGTGAA	corneal epithelium
TACCCACCACTACGGC	conjunctival epithelium
TACCCACCATAGAGGC	proliferating progenitors
TACCGGGCAGCGTGAA	corneal epithelium
TACGCTCGTGCCCAGT	endothelium
TACGCTCTCTGCATGA	neural crest
TACGGTATCATAGCAC	conjunctival epithelium
TACTGCCAGATCGCCC	neural crest
TACTGCCGTTGCATTG	neural crest
TACTTACGTAGCGCTC	corneal epithelium
TACTTACTCAGACCGC	corneal epithelium
TACTTCATCTTGCGCT	corneal epithelium
TACTTGTCAGAGCGTA	neural crest
TAGGTACCAGAGAATT	neural crest
TAGGTTGCATCCCACT	corneal epithelium
TAGGTTGGTGATTCAC	corneal epithelium
TATCAGGTCACCATAG	corneal epithelium
TATCAGGTCTGAGTCA	endothelium
TATCCTACAAGTCATC	proliferating progenitors
TATCGCCGTTGTCTAG	neural crest
TATTGCTGTGAGACGT	neural crest
TCAAGTGTCACGATAC	corneal epithelium
TCACACCAGGTGAGAA	neural crest
TCACACCTCTCGCCTA	conjunctival epithelium
TCAGCAAAGATGATTG	corneal epithelium
TCAGCAAAGTCATAGA	conjunctival epithelium
TCAGCAACAAAGACGC	neural crest
TCAGTCCAGGCCCACT	conjunctival epithelium
TCATATCCACTATGTG	corneal epithelium
TCATGAGTCACCATCC	neural crest
TCATTACAGTTACGTC	neural crest
TCATTACCAGCTATTG	neural crest
TCATTCACAAATGCGG	endothelium
TCATTGTCAAGTGGCA	neural crest
TCATTGTTCCTACCAC	conjunctival epithelium
TCCACGTGTCACTCGG	conjunctival epithelium
TCCATCGTCGCCTTTG	proliferating progenitors
TCCATGCAGCTACAAA	conjunctival epithelium
TCCCACAGTGGTCTGC	endothelium
TCCCACATCCGAAGGA	corneal epithelium
TCCCAGTCAAAGCAAT	corneal epithelium
TCCGGGACAAATAAGC	corneal epithelium
TCCTAATCAGCAGAAC	corneal epithelium
TCCTCCCTCTGTCGTC	conjunctival epithelium
TCCTCTTGTCGTGGAA	 keratocytes I
TCCTGCAGTATCACGT	conjunctival epithelium
TCGAACAGTTATTCTC	endothelium
TCGACGGGTGTGGTCC	neural crest
TCGACGGTCTTAAGGC	neural crest
TCGATTTTCAGGAGAC	proliferating progenitors
TCGGGCAAGTATGAAC	neural crest
TCGTCCAAGCCTGAGA	neural crest
TCGTCCACATTGAGGG	neural crest
TCGTGCTGTGTGTGGA	neural crest
TCGTGGGAGCCGGATA	corneal epithelium
TCTAACTAGGTGCTGA	corneal epithelium
TCTAACTGTCCTATAG	endothelium
TCTACATGTGCGAACA	neural crest
TCTACATGTTAATGAG	 keratocytes II
TCTCACGGTACGTAGG	neural crest
TCTCCGAAGTAGTGCG	corneal epithelium
TCTGCCACAGTTACCA	corneal epithelium
TCTGGCTCAAGTTGGG	corneal epithelium
TCTTCCTGTCACGCTG	neural crest
TCTTGCGCAGAGTCTT	neural crest
TCTTGCGTCCAAGCAT	corneal epithelium
TGACAGTGTGGGACAT	endothelium
TGACGCGGTAGTCTTG	conjunctival epithelium
TGACGCGTCCTTCAGC	neural crest
TGAGGGAAGCGCTGCT	neural crest
TGAGGGAAGTAGGGTC	conjunctival epithelium
TGAGGTTGTTTACACG	neural crest
TGAGGTTTCGGCCAAC	neural crest
TGAGTCAAGTAAACGT	conjunctival epithelium
TGATGGTGTAGTCTTG	corneal epithelium
TGATTCTTCTATCCAT	neural crest
TGCCGAGCAAATACGA	corneal epithelium
TGCCGAGTCCACAGGC	conjunctival epithelium
TGCCGAGTCCATATGG	corneal epithelium
TGCGATAAGAACAAGG	neural crest
TGCGGGTGTCTAACTG	neural crest
TGCTCCAGTAGCCCTG	corneal epithelium
TGCTCGTAGAGTTGTA	endothelium
TGCTCGTTCATTACGG	neural crest
TGCTGAACACGACGCT	 keratocytes I
TGCTGAATCTCTCGCA	corneal epithelium
TGCTTCGAGCAGGGAG	neural crest
TGCTTGCTCGGACGTC	proliferating progenitors
TGGAGAGAGCATAGGC	proliferating progenitors
TGGAGAGCATGAGAAT	neural crest
TGGAGGAGTTTGAACC	neural crest
TGGATCAGTACGAAAT	corneal epithelium
TGGGAGAAGCCGTAAG	endothelium
TGGGATTAGCGTATAA	corneal epithelium
TGGGCTGAGGTTACAA	neural crest
TGGTACATCGTGCGAC	 keratocytes I
TGGTTAGCATCATTTC	corneal epithelium
TGTAAGCCACGACAGA	neural crest
TGTAAGCTCAGAGCAG	neural crest
TGTCAGACAGTGTGCC	neural crest
TGTCCACAGATGTTGA	neural crest
TGTGATGAGTCATCCA	neural crest
TGTGATGGTATCGCGC	endothelium
TGTGTGAGTTGCATGT	conjunctival epithelium
TGTTACTGTGCATTTG	neural crest
TGTTCATAGGGACAGG	corneal epithelium
TGTTCTATCGTGGCTG	corneal epithelium
TGTTGAGCACCGTGGT	 keratocytes I
TGTTGAGCATTGCCGG	neural crest
TTAATCCTCACATCAG	corneal epithelium
TTACAGGCAACGGCTC	conjunctival epithelium
TTACCGCCAGTTGTTG	corneal epithelium
TTAGGCAGTTCTCCCA	corneal epithelium
TTAGGGTAGAGACAAG	endothelium
TTAGTCTGTGGGTTGA	neural crest
TTCAATCTCATACAGC	neural crest
TTCACCGAGGCGAAGG	endothelium
TTCCACGCAAATTGCC	 keratocytes II
TTCCGGTCATCATCCC	conjunctival epithelium
TTCCGGTCATGGTACT	corneal epithelium
TTCCGGTTCAGCTTGA	corneal epithelium
TTCCTAATCATCTATC	neural crest
TTCCTTCCAGGACATG	neural crest
TTCGCTGAGGCACTAG	neural crest
TTCTAACAGGTAGACC	corneal epithelium
TTCTCTCGTAGGTACG	neural crest
TTGACCCGTACCCAGC	corneal epithelium
TTGATGGCAGCTATAC	neural crest
TTGATGGCATATCGGT	corneal epithelium
TTGATGGGTGTACATC	neural crest
TTGCATTTCACCTGGG	mesoderm
TTGCATTTCAGTCAGT	neural crest
TTGCTGCAGATGGCGT	endothelium
TTGGGCGAGCCGGATA	neural crest
TTGGGCGAGCCTATTG	neural crest
TTGGGTATCTGTCCGT	neural crest
TTGGTTTCAGCAGACA	corneal epithelium
TTGTTTGAGCTAGAAT	endothelium
TTTCACATCCCTCTTT	corneal epithelium
TTTCATGGTATCGAAA	neural crest
TTTCCTCAGCATTGTC	corneal epithelium
TTTGACTCAAATCGTC	corneal epithelium
TTTGGAGCAAGATTGA	corneal epithelium
TTTGTTGAGCACGTCC	neural crest
